{
  "width": 20,
  "height": 20,
  "index": 0,
  "maxPlayers": 6,
  "map": [
    [1,1,1,1,1,1,1,1,1,1,1,1,1,1,1,1,1,1,1,1],
    [1,2,0,0,3,3,3,0,0,0,0,0,0,3,3,3,0,0,2,1],
    [1,0,0,1,1,3,3,0,4,4,0,0,3,3,1,1,0,0,0,1],
    [1,0,0,1,0,3,0,0,4,4,0,0,0,3,0,1,0,0,0,1],
    [1,0,0,0,0,0,0,1,0,0,0,0,1,0,0,0,0,0,0,1],
    [1,3,3,3,1,0,0,1,0,0,0,0,1,0,0,1,3,3,3,1],
    [1,3,3,0,1,0,0,0,0,0,0,0,0,0,0,1,0,3,3,1],
    [1,0,3,0,0,0,0,1,1,0,0,1,1,0,0,0,0,3,0,1],
    [1,0,0,0,4,4,4,0,0,0,0,0,0,4,4,4,0,0,0,1],
    [1,2,0,0,0,4,4,0,0,0,0,0,0,4,4,0,0,0,2,1],
    [1,0,0,0,0,0,0,0,1,1,1,1,0,0,0,0,0,0,0,1],
    [1,0,0,0,0,0,0,0,1,4,4,1,0,0,0,0,0,0,0,1],
    [1,0,0,0,0,0,0,0,1,1,1,1,0,0,0,0,0,0,0,1],
    [1,0,0,0,1,0,0,0,0,0,0,0,0,0,1,0,0,0,0,1],
    [1,0,0,0,1,0,0,1,0,0,0,0,1,0,0,1,0,0,0,1],
    [1,0,0,0,0,0,0,1,0,0,0,0,1,0,0,0,0,0,0,1],
    [1,0,0,1,1,0,0,0,0,0,4,4,0,0,1,1,0,0,0,1],
    [1,2,0,0,3,3,3,0,0,0,4,4,0,3,3,3,0,0,2,1],
    [1,0,0,0,3,3,0,0,0,0,0,0,0,0,3,3,0,0,0,1],
    [1,1,1,1,1,1,1,1,1,1,1,1,1,1,1,1,1,1,1,1]
  ]
}